80 80
5
200 160 2 1500 50 90 3 60 120 7
320 320 1 1600 30 80 1 40 120 7
480 160 1 1500 40 70 2 90 120 5
620 440 1 2500 70 50 2 30 60 7
840 800 2 2000 50 60 4 60 120 7
9
11 600 600 1
21 720 600 1
61 640 600 1
60 680 600 1
30 200 120 1
40 280 320 1
50 480 120 1
2 1160 1200 1
3 1120 1200 1
