32 32
1160 1080
5 5 5 5 5 5 5 5 5 5 5 5 5 5 5 5 5 5 5 5 5 5 5 5 5 5 5 5 5 5 5 5
5 0 2 1 3 0 0 0 0 0 3 0 0 2 0 0 0 0 0 0 0 0 0 2 0 0 0 0 0 0 0 5
5 0 0 0 3 0 0 0 0 2 4 1 0 0 0 0 0 0 0 0 0 0 1 1 0 2 0 0 0 0 0 5
5 0 0 0 3 0 0 4 0 0 3 0 0 3 4 3 4 3 4 4 4 0 0 4 4 4 4 4 4 4 4 5
5 0 0 2 3 0 0 3 0 0 4 0 1 3 0 0 0 0 0 0 0 0 0 0 1 0 0 0 0 0 0 5
5 2 0 0 0 0 0 4 0 1 3 1 0 3 1 0 0 0 0 0 0 0 1 0 0 0 1 0 0 0 0 5
5 0 1 0 0 0 0 3 0 0 4 0 0 3 0 2 3 3 3 3 4 3 3 4 4 3 4 3 4 3 3 5
5 3 3 3 4 3 3 4 0 0 4 0 0 4 0 0 3 0 0 3 0 0 0 3 2 2 3 0 1 0 0 5
5 0 0 0 0 0 0 0 1 0 3 0 1 3 0 0 3 1 0 3 0 0 0 3 0 0 0 0 0 3 0 5
5 0 2 0 0 0 0 0 0 0 3 0 0 3 0 2 3 0 0 0 0 0 0 4 0 2 0 2 0 3 0 5
5 0 0 3 3 3 4 3 3 3 4 1 0 3 0 0 0 0 1 0 0 0 1 0 0 0 0 0 0 0 0 5
5 0 2 0 0 2 0 1 1 0 3 0 0 4 1 0 0 0 0 2 4 0 0 0 0 2 0 3 0 0 0 5
5 0 0 0 1 0 0 0 0 0 3 0 1 3 0 0 3 0 3 0 4 0 0 3 0 3 0 3 0 4 3 5
5 0 0 4 4 4 4 3 4 4 3 0 0 3 1 0 4 0 3 0 0 2 0 4 0 3 0 3 0 0 0 5
5 0 0 1 0 0 0 0 0 0 4 0 0 4 0 0 3 1 3 0 0 0 0 3 0 0 0 3 0 1 0 5
5 0 0 0 0 0 0 1 0 0 4 0 0 4 0 1 3 3 3 3 3 3 3 3 3 3 4 4 4 0 0 5
5 0 0 3 3 3 4 3 3 3 3 0 0 3 1 0 3 0 0 0 0 0 0 0 0 0 1 0 1 0 0 5
5 0 0 0 2 0 0 0 0 1 0 1 0 4 0 0 3 0 2 0 0 2 0 0 1 0 0 0 0 0 0 5
5 0 2 0 0 0 1 0 0 0 0 0 0 3 0 0 3 0 0 0 2 0 0 0 0 4 3 3 4 3 3 5
5 0 0 0 0 0 0 0 0 0 0 2 0 3 0 0 3 0 0 0 0 0 1 0 0 4 0 0 0 0 0 5
5 3 3 3 0 3 0 3 3 4 3 3 3 3 4 4 3 4 3 3 0 0 3 3 4 4 0 0 0 0 0 5
5 1 0 0 0 3 0 0 0 0 3 0 0 0 0 2 4 0 0 0 0 0 0 0 0 3 0 0 3 1 0 5
5 0 1 0 0 3 1 0 2 0 3 0 0 0 0 0 4 0 2 0 0 0 0 0 0 4 0 0 3 0 0 5
5 0 0 1 0 3 0 0 0 0 4 0 1 0 0 0 4 0 0 0 0 1 0 2 0 3 0 0 3 0 0 5
5 0 0 0 0 3 0 2 0 0 3 0 0 0 1 0 0 1 0 0 0 0 0 0 0 3 0 0 3 0 1 5
5 0 2 0 0 3 0 0 2 0 3 0 1 0 0 0 0 0 0 0 0 1 0 0 0 4 0 0 3 0 0 5
5 0 0 0 0 3 0 0 0 0 4 0 0 0 0 0 4 0 0 0 0 0 0 0 0 4 0 0 3 2 0 5
5 0 0 0 0 3 0 1 0 0 3 0 0 0 1 0 4 0 0 0 0 0 0 0 0 3 0 0 3 0 0 5
5 2 0 3 3 3 3 3 0 0 3 0 0 4 3 3 3 4 4 3 4 3 3 3 3 3 0 0 3 2 0 5
5 0 0 0 2 0 2 0 0 0 4 0 0 0 0 1 0 0 0 0 0 0 0 2 0 0 0 2 3 0 0 5
5 0 2 0 0 0 0 0 1 0 3 0 0 0 0 0 0 2 0 0 0 0 0 0 0 0 0 0 3 0 0 5
5 5 5 5 5 5 5 5 5 5 5 5 5 5 5 5 5 5 5 5 5 5 5 5 5 5 5 5 5 5 5 5