80 80
5
220 120 1 500 20 100 1 120 120 5
240 340 1 700 30 95 2 80 120 5
600 60 2 800 40 90 3 60 180 5
640 420 2 1100 25 70 1 180 180 7
520 1180 1 1600 30 90 4 80 180 7
7
60 220 80 1
10 200 340 1
61 640 60 1
60 40 1200 1
50 680 420 1
1 1200 40 1000
20 540 1180 1
